s00wwwww0w00www
0w00000w0ww0w00
00ww0w000w0000w
w000wwww000wwww
000w00000w0w00w
ww0wwww0ww000ww
000www0000ww0ww
0w000ww0w0ww00w
0ww0w000w000www
www00wwww0wwwww
www0ww0w00ww00w
w000w00w0ww00ww
00ww00000000www
w0www0ww0ww0www
w0000www00w000f
aaaaaaaaaaaaaaa